AdjacencyMatrix	org.openscience.cdk.graph.matrix	core
AllRingsFinder	org.openscience.cdk.ringsearch	standard
AromaticAtomsCountDescriptor	org.openscience.cdk.qsar.descriptors.molecular	qsarmolecular
Aromaticity	org.openscience.cdk.aromaticity	standard
AtomContainerManipulator	org.openscience.cdk.tools.manipulator	standard
AtomCountDescriptor	org.openscience.cdk.qsar.descriptors.molecular	qsarmolecular
AtomTypeManipulator	org.openscience.cdk.tools.manipulator	standard
BasicAtomGenerator	org.openscience.cdk.renderer.generators	renderbasic
BasicBondGenerator	org.openscience.cdk.renderer.generators	renderbasic
BasicSceneGenerator	org.openscience.cdk.renderer.generators	renderbasic
BooleanResult	org.openscience.cdk.qsar.result	standard
CDKAtomTypeMatcher	org.openscience.cdk.atomtype	core
CDKConstants	org.openscience.cdk	core
CDKHydrogenAdder	org.openscience.cdk.tools	valencycheck
CircularFingerprinter	org.openscience.cdk.fingerprint	fingerprint
ConnectivityChecker	org.openscience.cdk.graph	standard
CycleFinder	org.openscience.cdk.graph	core
DebugChemObjectBuilder	org.openscience.cdk.debug	datadebug
DefaultChemObjectBuilder	org.openscience.cdk	data
DescriptorEngine	org.openscience.cdk.qsar	qsarmolecular
DescriptorValue	org.openscience.cdk.qsar	standard
DoubleArrayResult	org.openscience.cdk.qsar.result	standard
DoubleResult	org.openscience.cdk.qsar.result	standard
ElectronDonation	org.openscience.cdk.aromaticity	standard
Elements	org.openscience.cdk.config	core
Fingerprinter	org.openscience.cdk.fingerprint	standard
HybridizationFingerprinter	org.openscience.cdk.fingerprint	standard
IAtom	org.openscience.cdk.interfaces	interfaces
IAtomContainer	org.openscience.cdk.interfaces	interfaces
IAtomContainerSet	org.openscience.cdk.interfaces	interfaces
IBioPolymer	org.openscience.cdk.interfaces	interfaces
IBitFingerprint	org.openscience.cdk.fingerprint	core
IBond	org.openscience.cdk.interfaces	interfaces
IChemFile	org.openscience.cdk.interfaces	interfaces
IChemFormatMatcher	org.openscience.cdk.io.formats	interfaces
IChemObject	org.openscience.cdk.interfaces	interfaces
IChemObjectBuilder	org.openscience.cdk.interfaces	interfaces
IChemObjectReader	org.openscience.cdk.io	interfaces
IChemObjectReaderErrorHandler	org.openscience.cdk.io	interfaces
ICountFingerprint	org.openscience.cdk.fingerprint	core
IDescriptor	org.openscience.cdk.qsar	interfaces
IDescriptorResult	org.openscience.cdk.qsar.result	interfaces
IElement	org.openscience.cdk.interfaces	interfaces
IFingerprinter	org.openscience.cdk.fingerprint	core
IImplementationSpecification	org.openscience.cdk	interfaces
ILonePair	org.openscience.cdk.interfaces	interfaces
IMolecularDescriptor	org.openscience.cdk.qsar	qsar
IMonomer	org.openscience.cdk.interfaces	interfaces
InChIGenerator	org.openscience.cdk.inchi	inchi
InChIGeneratorFactory	org.openscience.cdk.inchi	inchi
InChINumbersTools	org.openscience.cdk.graph.invariant	inchi
IntegerArrayResult	org.openscience.cdk.qsar.result	standard
IntegerResult	org.openscience.cdk.qsar.result	standard
IReaction	org.openscience.cdk.interfaces	interfaces
IRing	org.openscience.cdk.interfaces	interfaces
ISingleElectron	org.openscience.cdk.interfaces	interfaces
IsotopeFactory	org.openscience.cdk.config	core
Isotopes	org.openscience.cdk.config	core
IStrand	org.openscience.cdk.interfaces	interfaces
IteratingPCCompoundXMLReader	org.openscience.cdk.io.iterator	io
IteratingSDFReader	org.openscience.cdk.io.iterator	ctab
MACCSFingerprinter	org.openscience.cdk.fingerprint	fingerprint
MDLRXNReader	org.openscience.cdk.io	ctab
MDLV2000Writer	org.openscience.cdk.io	ctab
ModelBuilder3D	org.openscience.cdk.modeling.builder3d	builder3d
Mol2Format	org.openscience.cdk.io.formats	ioformats
MolecularFormulaManipulator	org.openscience.cdk.tools.manipulator	formula
PDBReader	org.openscience.cdk.io	pdb
RebondTool	org.openscience.cdk.graph.rebond	standard
SilentChemObjectBuilder	org.openscience.cdk.silent	silent
SmilesGenerator	org.openscience.cdk.smiles	smiles
SmilesParser	org.openscience.cdk.smiles	smiles
StructureDiagramGenerator	org.openscience.cdk.layout	sdg
SybylAtomTypeMatcher	org.openscience.cdk.atomtype	atomtype
TopologicalMatrix	org.openscience.cdk.graph.matrix	qsarmolecular
UniversalIsomorphismTester	org.openscience.cdk.isomorphism	standard
VABCVolume	org.openscience.cdk.geometry.volume	standard
XMLIsotopeFactory	org.openscience.cdk.config	extra
